Name	Token	Code
Death	DT	DT
Neutral	NU	NU
Walk	WL	WL
Run	RN	RN
Get Hit	GH	GH
Town Neutral	TN	TN
Town Walk	TW	TW
Attack1	A1	A1
Attack2	A2	A2
Block	BL	BL
Cast	SC	SC
Throw	TH	TH
Kick	KK	KK
Skill1	S1	S1
Skill2	S2	S2
Skill3	S3	S3
Skill4	S4	S4
Dead	DD	DD
Sequence	GH	SQ
Knock back	GH	KB
